R    700 500 

NO ./path_to_the_north_text      
SO ./path_to_the_south_text    
WE ./path_to_the_west_text   
EA ./path_to_the_east_text   
S ./path_to_the_sprite_text     

F 0,250,150 
C 0,130,130

01111111
10000001
1200W001
10000001
10000001
111011111111
100000000001
101010010001
100000010001
100000010001
101010010001
11101111000111
101111010111
111111111000
