R    700 500 

NO ./textures/stone.xpm      
SO ./textures/mossy.xpm    
WE ./textures/redbrick.xpm   
EA ./textures/wood.xpm   
S  ./textures/pillar.xpm     

C 255,255,255 
F 255,0,0

01111111
10000001
12000001
10000001
10000001
111011111111
100000000001
101010010001
100000010001
100000010001
101010010N01
11101111000111
101111010111
111111111000
