R    1000 1500 

NO ./path_to_the_north_text    
SO ./path_to_the_south_text				
WE ./path_to_the_west_text

EA ./path_to_the_east_text
S ./path_to_the_sprite_text   

F 0,250,150 
C 0,130,130

10000000
111111111111111111111111111110000
10000000001100000000000000001
10110000011100000020000010001
10010000000000000000000001001
1011000001110000000000001000111111111
10000000001100000111011110001
11110111111111011100000010001
11110111111111011101010010001
1100000011010101110000001000111
100020000000000011000000100111
10000000000000001101010010001
11000000110101011111011110001
11100001111111111111000000N00111
11111111111111111111111111111
00000000