R    700 500 

NO ./path_to_the_north_text      
SO ./path_to_the_south_text    
WE ./path_to_the_west_text   
EA ./path_to_the_east_text   
S ./path_to_the_sprite_text     

F 0,250,150 
C 0,130,130

0 1 1 1 1 1 1 1
1 0 0 0 0 0 0 1
1 2 0 0 W 0 0 1
1 0 0 0 0 0 0 1
1 0 0 0 0 0 0 1
1 1 1 0 1 1 1 1 1 1 1 1
1 0 0 0 0 0 0 0 0 0 0 1
1 0 1 0 1 0 0 1 0 0 0 1
1 0 0 0 0 0 0 1 0 0 0 1
1 0 0 0 0 0 0 1 0 0 0 1
1 0 1 0 1 0 0 1 0 0 0 1
1 1 1 0 1 1 1 1 0 0 0 1 1 1
1 0 1 1 1 1 0 1 0 1 1 1
1 1 1 1 1 1 1 1 1 0 0 0
