R	1920 1080 

NO ./path_to_the_north_text    
SO ./path_to_the_south_text				
WE ./path_to_the_west_text

EA ./path_to_the_east_text
S ./path_to_the_sprite_text   

F 0,150,150 
C 0,130,130


11111111111111111111111111111
10000000001100000000000000001
10110000011100000020000010001
10010000000000000000000001001
10110000011100000000000010001
10000000001100000111011110001
11110111111111011100000010001
11110111111111011101010010001
11000000110101011100000010001
10002000000000001100000010001
10000000000000001101010010001 
11000000110101011111011110N01
11100001111111111111000000001
11111111111111111111111111111