 R    900 600 

    NO ./textures/stone.xpm     
 SO ./textures/mossy.xpm   
   WE ./textures/redbrick.xpm  
EA ./textures/wood.xpm  
S  ./textures/pillar.xpm    

C     255,255,255 
F  255,0,0

 111111111111111111111111111111
10000000000000000000000000000011111
11111111111000000000100000000000001
10000000001000000000100000000000001
10200002001000000000100100000000001
1000020000100000000010000010111111
10200000N01000000000100001000000001
11111111111000000000100010000020001
10000200000000000000100100200000001
11111100000000010000101000002000001
     100000000000000110000000002001
      1111111111111111111111111111